1,1,1,1,1,1,1,1,1,1,1,1,1,1,1,1,1,1,1,1
1,4,0,0,0,0,0,0,0,1,1,0,0,0,0,0,0,0,4,1
1,0,1,1,1,0,1,1,0,1,1,0,1,1,0,1,1,1,0,1
1,0,1,1,1,0,1,1,0,1,1,0,1,1,0,1,1,1,0,1
1,0,1,1,1,0,1,1,0,1,1,0,1,1,0,1,1,1,0,1
1,0,0,0,0,0,0,0,0,0,0,0,0,0,0,0,0,0,0,1
1,0,1,1,1,1,0,1,1,1,1,1,1,0,1,1,1,1,0,1
1,0,0,0,0,0,0,0,0,0,0,0,0,0,0,0,0,0,0,1
1,0,1,1,0,0,0,0,0,0,0,0,0,0,0,0,1,1,0,1
1,0,1,0,0,0,0,1,1,6,6,1,1,0,0,0,0,1,0,1
7,0,0,0,0,0,0,1,2,2,2,2,1,0,0,0,0,0,0,7
1,0,1,0,0,1,0,1,1,1,1,1,1,0,1,0,0,1,0,1
1,0,0,0,1,1,0,0,0,0,0,0,0,0,1,1,0,0,0,1
1,0,1,0,1,1,1,1,0,1,1,0,1,1,1,1,0,1,0,1
1,0,0,0,0,0,0,1,0,0,0,0,1,0,0,0,0,0,0,1
1,0,1,0,0,0,0,1,1,1,1,1,1,0,0,0,0,1,0,1
1,0,0,0,0,0,0,0,0,0,0,0,0,0,0,0,5,0,0,1
1,0,1,1,1,0,1,1,0,1,1,0,1,1,0,1,1,1,0,1
1,4,0,0,0,0,0,0,0,0,0,0,0,0,0,0,0,0,4,1
1,1,1,1,1,1,1,1,1,1,1,1,1,1,1,1,1,1,1,1