0 0 0 0 0 0 0 0 0 0 0 0 0 0 0 0 0 0 0 0
0 1 1 1 1 1 1 1 1 1 1 1 1 1 1 1 1 1 1 0
0 1 0 0 1 0 0 1 0 0 0 0 0 1 0 1 0 0 1 0
0 1 1 1 1 0 0 1 1 1 1 1 1 1 0 1 1 1 1 0
0 1 0 0 1 0 0 0 0 0 1 0 0 0 0 1 0 0 1 0
0 1 1 1 1 0 0 1 1 1 1 1 1 1 0 1 0 0 1 0
0 0 0 0 1 0 0 1 0 6 6 6 0 1 0 1 0 0 1 0
7 1 1 1 1 1 1 1 0 2 2 2 0 1 1 1 1 1 1 7
0 0 0 0 1 0 0 1 0 0 0 0 0 1 0 1 0 0 1 0
0 0 0 0 1 0 0 1 1 1 1 1 1 1 0 1 0 0 1 0
0 0 0 0 1 0 0 1 0 0 0 0 0 1 0 1 0 0 1 0
0 1 1 1 1 1 1 1 1 1 1 1 1 1 1 1 1 1 1 0
0 1 0 0 1 0 0 0 0 0 1 0 0 0 1 0 0 1 0 0
0 1 0 0 1 1 1 1 1 1 1 1 1 1 1 1 0 1 0 0
0 1 0 0 1 0 0 1 0 0 0 0 0 1 0 1 0 1 0 0
0 1 0 0 1 0 0 1 0 0 0 0 0 1 0 1 0 1 0 0
0 1 1 1 1 0 0 1 1 1 1 1 1 1 0 1 1 1 1 0
0 1 0 0 1 0 0 0 0 0 1 0 0 0 0 0 0 0 1 0
0 1 1 1 1 1 1 1 1 1 1 1 1 1 1 1 1 1 1 0
0 0 0 0 0 0 0 0 0 0 0 0 0 0 0 0 0 0 0 0 